-22
-10
21
-1
00000000000000000000000000000000000000000000
00000000000000000000000000000000000000000000
00000000000000000000000000000000000000000000
00000000000000000000000000000000000000000000
00000000000000000000000000000000000000000000
00000000000000000000000000000000000000000000
00000000000000000000000000000000000000000000
33333313333333333333333333333333333333333333
22222222222222222222222222222222222222222222
22222222222222222222222222222222222222222222
